11111111111
22232222222
00004400000
00004400000
00000000000
00000000000
00000000000
78962222444
