111111111111111111111
100000000010000000001
101110111010111011101
100000000000000000001
101110101111101011101
100000100010001000001
111110111000111011111
111110100000001011111
111000001131100000111
111011101111101110111
100000000010000000001
101110111010111011101
100010000000000010001
111000101111101000111
110010100010001010011
110110111010111011011
110060009008000700011
111111111111111111111
