222222222222222222222222222222222222222222222
222222222222222222222222222222222222222222222
222222221122222222222222222222222211222222222
222222221111222222222222222222221111222222222
222222221113122222222222222222210111222222222
222222221110011222222222222221100111222222222
222222222110000122222222222210000112222222222
222222222110000011221111221100000112222222222
222222222210000000110000110000000122222222222
222222222210000000000000000000000122222222222
222222222221000000000000000000001222222222222
222222222222101000000000000001012222222222222
222222222222210000000000000000122222222222222
222222222222210000000000000000122222222222222
222222222222100011000000001100012222222222222
222222222222100121100000011210012222222222222
222222222222100111100000011110012222222222222
222222222222100011000110001100012222222222222
222222222221004400000000000044001222222222222
222222222221044440010110100444401222222222222
222222222221044440001111000444401222222222222
222222222222104400001441000044012222222222222
222222222222210000001441000000122222222222222
222222222222221100000110000011222222222222222
222222222222222211100000011122222222222222222
222222222222222222211111122222222222222222222
222222222222222222222222222222222222222222222
222222222222222222222222222222222222222222222
