22222111122222
22221223212222
22212222001222
22100222000122
22100222000122
21000222200212
21002222222212
12222200022221
12222000002221
10022000002221
10002000002001
21002200020012
21002222220012
22122222220122
22211222211222
22222111122222
