2222222222222222
2222223222222222
2222222222222222
2222222222222222
2222111122222222
2222111122222222
2222221122222222
2222221122222222
2222221122222222
2222221122222222
0000222211111144
0000222211111144
1100002200001144
1100002200001144
1111112200004444
1111112200004444
